NO ./metal1.xpm



SO ./tex.xpm



WE    ./tex.xpm
EA ./tex.xpm

F 30,0,0
C  80,0,70































111111111111
10000S000001
100000000001
100000000001
111111111111
