no ./tex.xpm
so ./tex.xpm
we ./tex.xpm
ea ./tex.xpm
f_color 30,0,30
c_color 80,0,70

111111111111
10000S000001
100000000001
100000000001
111111111111
