NO ./tex.xpm
SO ./tex.xpm
WE ./tex.xpm
EA ./tex.xpm
F 220,100,0
C 225,30,0

11111111111111111111111111
10000000001100000000000001
1011000001110000000S000001
10010000000000001000000001
11111111101100001000000001
10000000001100001000000001
10000000010100001000000001
10000000100010001000000001
10000001000001001000000001
10000010000000001011111111
10000100000000001000000011
10001000000000001000000011
10000000000000001000000011
10000000011000111111100111
10110000011100000000000001
10110000011100001110110001
10110000011100001000010001
10111111111100001000010001
10000000000111111000010001
10000000000000001000010001
10000000000000000000010001
10000000000000000000010001
10000000000000000000010001
10000000000000000000010001
11111111110001111111111111
         10001
         10001
        1000001
        1111111