NO ./blue_wall.xpm
SO ./blue_wall.xpm
WE ./blue_wall.xpm
EA ./blue_wall.xpm
F 30,0,30
C 80,0,70
111111111111111111111111111111111111111111111111111111111111111111111111111
100000000000000000000000000000000000000000000000000000000000000000000000001
101111111111111111111111111111111111111111111111111111111111111111111111101
1S1111111111111111111111111111111111111111111111111111111111111111111111101
101111111111111111111111111111111111111111111111111111111111111111111111001
101111111111111111111111111111111111111111111111111111111111111111111110001
100111111111111111111111111111111111111111111111111111111111111111111100001
100011111111111111111111111111111111111111111111111111111111111111111000001
100000000000000000000000000000000000000000000000000000000000000000000000001
100000111111111111111111111111111111111111111111111111111111111111100000001
100000011111111111111111111111111111111111111111111111111111111111000000001
100000001111111111111111111111111111111111111111111111111111111110000000001
100000000111111111111111111111111111111111111111111111111111111100000000001
101000000000000000000000000000000000000000000000000000000000000000000000101
101000000000000000000000000000000000000000000000000000000000000000000000101
101000000000000000000000000000000000000000000000000000000000000000000000101
101000000000000000000000000000000000000000000000000000000000000000000000001
101000000000000000000000000000000000000000000000000000000000000000000000001
101000000000000000000000000000000000000000000000000000000000000000000000001
101000000000000000000000000000000000000000000000000000000000000000000000001
101000000000000000000000000000000000000000000000000000000000000000000000001
101111111111111111111111111111111111000011111111111111111111111111111110001
101000000000000000000000000000000000000000000000000000000000000000000000001
101000000000000000000000000000000000000000000000000000000000000000000000001
101000000000000000000000000000000000000000000000000000000000000000000000001
101000000000000000000000000000000000000000000000000000000000000000000000001
101000000000000000000000000000000000000000000000000000000000000000000000001
101000000000000000000000000000000000000000000000000000000000000000000000001
101000000000000000000000000000000000000000000000000000000000000000000000001
101000000000000000000000000000000000000000000000000000000000000000000000001
111111111111111111111111111111111111111111111111111111111111111111111111111
