NO ./path_to_the_north_texture
SO ./path_to_the_south_texture
WE ./path_to_the_west_texture
EA ./path_to_the_east_texture
F 220,100,0
C 225,30,0

11111111111111111111111111
10000000001100000000000001
1011000001110000000S000001
10010000000000001000000001
11111111101100001000000001
10000000001100001000000001
10000000011100001000000001
10000000111110001000000001
10000001111111001000000001
10000011111111101011111111
10000111111111101000000011
10000000000000001000000011
10000000011000111111100111
10110000011100000000000001
10110000011100001110110001
10110000011100001000010001
10111111111100001000010001
10000000000111111000010001
10000000000000001000010001
10000000000000000000010001
10000000000000000000010001
10000000000000000000010001
10000000000000000000010001
11111111110001111111111111
         10001
         10001
        1000001
        1111111