NO ./tex.xpm
SO ./tex.xpm
WE ./tex.xpm
EA ./tex.xpm
F  30,       0 ,         30
C 80,0,70

111111111111
10000N000001
111111111111


